24
16
5 5 5 5 5 5 5 5 5 5 5 5 5 5 5 5 5 5 5 5 5 5 5 5
5 5 5 5 5 5 5 5 5 5 5 5 5 5 5 5 5 5 5 5 5 5 5 5
5 5 5 5 5 5 5 5 2 5 5 5 5 5 5 5 5 5 5 5 5 6 5 5
5 5 5 5 5 5 5 5 5 5 5 5 5 5 5 5 5 5 5 5 2 2 5 5
5 5 5 5 5 2 5 5 5 5 5 5 2 5 5 5 5 5 5 5 5 5 5 5
5 5 5 5 5 5 5 5 5 5 5 5 5 5 5 5 5 5 2 5 5 5 5 5
5 5 2 5 5 5 5 5 5 5 5 5 5 5 5 5 5 5 5 5 5 5 5 5
5 5 5 5 5 2 2 5 5 5 5 5 5 5 5 5 5 5 5 5 2 5 5 5
5 5 5 5 5 5 5 5 5 2 2 5 5 5 5 5 5 3 5 5 5 5 5 5
5 5 5 5 5 5 5 5 5 5 5 5 5 5 5 5 3 3 3 5 5 5 5 5
5 5 5 5 5 5 5 5 3 5 5 5 5 5 5 3 3 3 3 3 5 5 5 5
5 5 5 5 5 5 5 3 3 3 5 5 5 5 5 5 5 4 5 5 5 5 5 5
5 5 5 2 5 5 5 5 4 5 5 5 5 5 5 5 5 4 5 5 5 5 5 5
5 5 5 5 5 5 5 5 2 5 5 5 5 5 5 5 2 2 2 5 5 5 5 5
5 5 5 5 5 5 5 5 5 5 5 5 5 5 5 5 5 5 5 5 5 5 5 5
0 0 0 0 0 0 0 0 0 0 0 0 0 0 0 0 0 0 0 0 0 0 0 0
100
300