24
16
5 5 5 5 5 5 5 5 5 5 5 5 5 5 5 5 5 5 5 5 5 5 5 5
5 5 5 5 5 5 5 5 5 5 5 5 5 5 5 5 5 5 5 5 5 5 5 5
5 5 5 5 5 5 5 5 2 5 5 5 5 5 5 5 5 5 5 5 5 6 5 5
5 5 5 5 5 5 5 5 5 5 5 5 5 5 5 5 5 5 5 5 2 2 5 5
5 5 5 5 2 2 5 5 5 5 5 5 2 5 5 5 5 5 5 5 5 5 5 5
5 5 5 5 5 5 5 5 5 5 5 5 5 5 5 5 5 5 2 5 5 5 5 5
5 5 2 2 5 5 5 5 5 5 5 5 5 5 5 5 5 5 5 5 5 5 5 5
5 5 5 5 5 2 2 5 5 5 5 5 5 5 5 5 5 5 5 5 2 5 5 5
5 5 5 5 5 5 5 5 5 2 2 5 5 5 5 5 5 3 5 5 5 5 5 5
5 5 5 5 5 5 5 5 5 5 5 5 5 5 5 5 3 3 3 5 5 5 5 5
5 5 5 5 5 5 5 5 3 5 5 5 5 5 5 3 3 3 3 3 5 5 5 5
5 5 5 2 5 5 5 3 3 3 5 5 5 5 5 5 5 4 5 5 5 5 5 5
5 5 5 1 5 5 5 5 4 5 5 5 5 5 5 5 5 4 5 5 5 5 5 5
5 5 2 1 2 5 5 5 2 5 5 5 5 5 5 5 2 2 2 5 5 5 5 5
5 2 1 1 1 2 5 5 5 5 5 5 5 5 5 5 5 5 5 5 5 5 5 5
2 1 1 1 1 1 2 0 0 0 0 0 0 0 0 0 0 0 0 0 0 0 0 0
